{
    "metadata": {
        "title": "test",
        "dimensions": [6, 6, 2]
    },
    "blocks": [
        [
            [0, 0, 0, 0, 0, 0],
            [0, 1, 1, 1, 0, 0],
            [0, 1, 1, 1, 0, 0],
            [0, 0, 1, 1, 0, 0],
            [0, 0, 1, 1, 0, 0],
            [0, 0, 0, 0, 0, 1]
        ],
        [
            [0, 0, 0, 0, 0, 0],
            [0, 0, 0, 0, 0, 0],
            [0, 0, 0, 1, 0, 0],
            [0, 0, 0, 1, 0, 0],
            [0, 0, 0, 0, 0, 0],
            [0, 0, 0, 0, 0, 0]
        ]
    ]
}